{
    "tile_size": 32,
    "tilemap": [
        [1, 1, 1, 1, 1, 1, 1, 1],
        [1, 0, 1, 0, 0, 0, 0, 1],
        [1, 0, 1, 0, 0, 0, 0, 1],
        [1, 0, 0, 0, 0, 0, 0, 1],
        [1, 0, 0, 0, 0, 0, 0, 1],
        [1, 0, 0, 0, 0, 1, 0, 1],
        [1, 0, 0, 0, 0, 0, 0, 1],
        [1, 1, 1, 1, 1, 1, 1, 1]
    ],
    "player": {
        "x": 128,
        "y": 128,
        "angle": -90
    }
}
